NO                          ./textures/stone_wall.xpm
SO ./textures/stone_wall2.xpm
WE ./textures/wall_1.xpm
EA ./textures/eagle.xpm

F 75,108,87
C 173,216, 230

111111111111111
1000100001 1001
100010000110001
100000010000001
10000      0001
100000000000001
10000N000000001
100001000001001
11111111111 111
111111111111111
