NO ./textures/1.xpm
SO ./textures/dark2.xpm
WE ./textures/dark1.xpm
EA ./textures/dark2.xpm

F 0, 0, 0
C 0, 0, 0

111111111111111111111
100010000000110000111
110010000000110001
110000000011000100111
11 10010000   0000001
 11100000000111100111
1111000  000110000001
1000000  00011111111
10000N00 000110000001
10000100 001110000001
111111111111 1111111