NO ./textures/1.xpm
SO ./textures/dark2.xpm
WE ./textures/dark1.xpm
EA ./textures/dark2.xpm

F 0, 0, 0
C 0, 0, 0

1111111111111111111 1
100010000000110000111
1100100000001100011
110000000011000100111
11 10010000   0000111
 11100000000111100111
1111000  000110000001
  1000000  00011111111
10000N00 000110000001
10000100 001110000001
11111111111 111111111