
NO ./textures/eagle.xpm
SO ./textures/purplestone.xpm
WE ./textures/bluestone.xpm
EA ./textures/wood.xpm
F 75,108,87
C 173,216, 230

		11111111111111111111111111111
		10000000110110000000000001111
1111111111011000001110000000000000001
1001000000000000001E00000000111111111
11111111101100000111000000001
10000000001100000111011111111
11110111111111011100000010001
11110111111111011101010010001
11000000110101011100000010001
10000000000000000000000010001
10000000000000001101010010001
11000000000010101110111100111
11011111011101011101111010001
11111111111111111111111111111