111111111111111
100010000000001
100010000000001
100000000000001
100000010000001
100000000000001
100000000000001
100000000000001
10000N000000001
100001000000001
111111111111111