11111111
10000001
10000N01
10000101
11111111