11111111111111111111
10000000000000001001
10000000000000000001
10000100000001000001
10000100000001000001
10000000000000000011
10000100000001000001
100000000N0000000001
11111111111111111111