11111111111111111
10000000000000001
10000001000000001
10000000000000001
10001000001000001
10000100010000001
10000000000000001
1000000N000000001
10000001000000001
11111111111111111