1111111111
1000000001
1000000101
1000000001
1000100001
1000010001
1000000001
1000000W01
1000000101
1111111111