NO ./textures/redbrick.xpm
SO ./textures/purplestone.xpm
WE ./textures/bluestone.xpm
EA ./textures/wood.xpm

1111111111111
1000100000001
1000100000001
1000000000001
1000000100001
1000000000001
1000000000001
1000000000001
10000N0000001
1000010000001
1111111111111