
NO ./textures/redbrick.xpm
SO ./textures/purplestone.xpm
WE ./textures/bluestone.xpm
EA ./textures/wood.xpm
F 77,92,53
C 163,208, 0

11111111111111111111111111111
10000000110110000000000001111
10110000011100000000000011111
1001000000000000000N000011111
11111111101100000111000000001
10000000001100000111011111111
11110111111111011100000010001
11110111111111011101010010001
11000000110101011100000010001
10000000000000000000000010001
10000000000000001101010010001
11000000000010101110111100111
11011111011101011101111010001
11111111111111111111111111111