
NO ./textures/greystone.xpm
SO ./textures/purplestone.xpm
WE ./textures/redbrick.xpm
EA ./textures/wood.xpm
F 77,92,53
C 163,208, 0

		11111111111111111111111111
		10000000110110000000000001
		1011000001110000000000001
		1001000000000000000000001
111111111011000001110000000000001
100000000011000001110111110111111
11110111111111011100000010001
11110111111111011101010010001
11000000110101011100000010001
10000N00000000000000000010001
10000000000000001101010010001
11000000000010101110111100111
11011111011101011101111010001
11111111111111111111111111111
